{
  "(": 0,
  ")": 1,
  "0": 2,
  "1": 3,
  "A": 4,
  "I": 5,
  "J": 6,
  "M": 7,
  "O": 8,
  "S": 9,
  "W": 10,
  "_junk": 11,
  "b": 12,
  "c": 13,
  "d": 14,
  "e": 15,
  "f": 16,
  "g": 17,
  "h": 18,
  "k": 19,
  "l": 20,
  "n": 21,
  "p": 22,
  "q": 23,
  "r": 24,
  "t": 25,
  "u": 26,
  "x": 27,
  "y": 28,
  "z": 29
}